1111111111111111111111111111111111111
10010000000001000100000000000000000C1
1001000001000100010000000000000000001
1001000001000000010000000000000000001
1001000001111101111111110000000000001
1000001110000001000000011111111111001
1P0011E000000000000000000000000000001
1111111111111111111111111111111111111